동국제약: dkpharm.co.kr
쌍계명차: ssanggye.co.kr
HD현대: hd.com
두산매거진: NOT_FOUND
두산연강재단: NOT_FOUND
한국피자헛: NOT_FOUND
LG에너지솔루션: lgensol.com
신한금융지주회사: shinhangroup.com
강남중고명품 아마레스: NOT_FOUND
롯데쇼핑e커머스사업본부: NOT_FOUND
롯데쇼핑롯데마트사업본부: NOT_FOUND
ktHCN: kthcn.co.kr
KT ENA: ena.skylife.co.kr
구해줘아파트닷컴: guhae.com
두산산업차량: doosaniv.com
kt M모바일: ktmmobile.com
셀트리온스킨큐어: celltrionskincure.com
비와이엔블랙야크: blackyak.com
운세다방: NOT_FOUND
삼성닷컴: samsung.com
약손명가: yaksonmyeongga.com
컬리: kurly.com
어도비: adobe.com
SBI저축은행: sbisb.co.kr
헤이리스: NOT_FOUND
에이블리코퍼레이션: a-bly.com
네오팜: neopharm.co.kr
노블스 결혼정보회사: nobles.co.kr
컴투스홀딩스: com2us.com
티웨이항공: twayair.com
굿리치: goodrich.co.kr
에듀윌: eduwill.net
뱅크샐러드: banksalad.com
네이버파이낸셜: naverfincorp.com
카카오모빌리티: kakaomobility.com
글락소스미스클라인: gsk.com
코웨이공식몰: coway.com
유세린: eucerin.kr
법무법인YK: yklaw.net
경동나비엔스토어: navien.com
나비엔: navien.com
SK매직인증사이트: skmagic.com
필립스 소닉케어: philips.co.kr
라이나생명공식사이트: lina.co.kr
이지수능교육: etoos.com
크레버스: creverse.com
월스트리트잉글리시: wallstreetenglish.co.kr
박문각: pmg.co.kr
해커스공무원: hackers.com
그린컴퓨터아카데미: greenart.co.kr
